1 1 1 1 1 1 1 1 1 1
1 0 0 0 0 0 0 0 0 1
1 0 0 0 0 0 0 0 0 1
1 0 0 1 0 1 1 1 0 1
1 0 0 1 94 948 9487 0 0 1
1 0 0 1 0 1 1 1 0 1
1 1 0 0 0 0 0 0 0 1
1 0 7 87 1 1 0 0 0 1
1 0 0 0 0 0 0 0 0 1
1 1 1 1 1 1 1 1 1 1