0 0 0 0 0 0 1 0 0 0
0 1 1 1 0 0 1 1 1 0
0 0 1 1 1 0 0 0 8888 0
0 0 0 8888 0 0 8888 0 1 0
0 94 0 8888 0 0 0 0 8888 0
0 0 0 0 0 8888 0 0 0 0
1 1 1 8888 0 0 0 8888 0 0
0 0 0 0 0 0 0 0 0 0
0 1 1 0 0 1 1 1 0 0
9487 1 1 0 0 1 1 1 0 87