1 1 1 1 1 1 1 1 1 1
1 1 1 1 1 1 1 1 1 1
1 1 0 0 0 0 0 0 0 1
1 1 0 0 0 0 0 0 0 1
1 1 0 94 1 1 9487 0 0 1
1 1 0 0 1 1 0 0 0 1
1 1 0 0 1 1 0 0 0 1
1 1 0 0 87 0 0 0 0 1
1 1 1 1 1 1 1 1 1 1
1 1 1 1 1 1 1 1 1 1