0 0 0 1 0 0 1 0 0 0
0 0 0 1 0 0 1 1 1 0
0 1 1 1 0 0 0 0 1 0
0 0 0 0 0 0 0 0 1 0
0 94 1 1 0 0 0 0 0 0
0 0 0 1 0 0 0 0 0 0
1 1 1 1 0 0 0 1 0 0
0 0 0 0 0 1 0 1 0 0
0 1 1 0 0 1 0 1 0 0
9487 1 1 0 0 1 0 1 87 0