1 1 1 1 1 1 1 1 1 1
1 0 0 0 0 0 0 0 0 1
1 0 0 0 0 7 0 0 0 1
1 0 0 1 1 1 94 0 0 1
1 0 0 0 0 948 9487 0 0 1
1 0 0 0 87 1 0 0 0 1
1 0 0 1 1 1 0 0 0 1
1 0 0 0 0 0 0 0 0 1
1 0 0 0 0 0 0 0 0 1
1 1 1 1 1 1 1 1 1 1